suddenly : repentinamente
early: temprano
town: pueblo
quiet: trankilo , silencioso
quite: bastante
enought:suficiente
head: cabeza, dirigir , encabezar
though: aunque , siquiera
through: a travez , mediante
whole: integro, totalidad
odd: extraño, impar
facts: hechos
doubt: duda
realise: darse cuenta de
further: fomentar
sligthly: ligeramente
far:mucho, lejos
nearly: casi , cerca
shall: debera
grumpy:gruñona
regret: lamentar
avoid:evitar
guess:adivinar
guest:invitado
hence: por lo tanto, por eso
upon:sobre
above:encima
bellow:abajo
reach:alcanzar,alcance,extension,distancia
scope:ambito,alcance
through: a traves, mediante
throw:lanzar,tirar
across: a traves
Though: aunque, si quiera , sin embargo
improved: mejorado
task: tarea
